NO ./path_to_the_north_texture
 SO ./path_to_the_south_texture
 WE ./path_to_the_west_texture
 EA ./path_to_the_east_texture
 F 0,0,255
 C 0,0,255



1111111111111111111111111111
1000000000110000000000000001
1011000001110000000W00000001
1001000000000000000000000001
1111111110110000011100000001
1000000000110000011101111111
11110111111111111   1
    1