 NO ./path_to_the_north_texture asdfsssa
 SO ./path_to_the_south_texture
 WE ./path_to_the_west_texture

 EA ./path_to_the_east_texture

 F       0,0,255

 C  255,0,0

1111111
1010001
100N101
1010001
1010001
1010001
1010001
1010001
1010001
1010001
1010001
1010001
1111111