 NO ./path_to_the_north_texture asdfsssa
 SO ./path_to_the_south_texture
 WE ./path_to_the_west_texture

 EA ./path_to_the_east_texture

 F       0,0,255

 C  255,0,0

111111111111111111111111111111111111111
100000000000000000000000000000000000001
100000000000000000000000000111110000001
100000000000000000000000000000010000001
100000000000000000000000000000010000001
100000000000000000000000000000010000001
100000000000000000000000000000010000001
100000000000000000000000000000010000001
1000000000000N0000000000000000010000001
100000000000000000000000000000000000001
100000000000000000000000000000000000001
100000000000000000000001000000000000001
100000000000000000000000100000000000001
100000000000000000000000010000000000001
100000000000000000000000001000000000001
100000000000000000000000000100000000001
111111111111111111111111111111111111111