 NO ./path_to_the_north_texture
 SO ./path_to_the_south_texture
 WE ./path_to_the_west_texture
 WE ./path_to_the_west_texture
 EA ./path_to_the_east_texture

 F 220,100,0
 C 225,30,0



        1111111111111111111111111
        1000001000110000000000001
        1W011000001110000000000001
        1100100000000000000000001
111111111011000001110000000000001
100000000011000001110111111111111
11110111111111011100000010001
11101111111110111010100100001
1100000011 101011100000010001
10000000011100001100000010001
1000000000000001101010010001
1100000111010101111101111010111
11110111 1110101 101111010001
11111111 1111111 111111111111