 NO ./path_to_the_north_texture asdfsssa
 SO ./path_to_the_south_texture
 WE ./path_to_the_west_texture

 EA ./path_to_the_east_texture

 F       255,255,255

 C  0,0,0

1111
1001
10N1
1111
