 NO ./path_to_the_NOrth_texture
 SO ./path_ to_the_south_texture
 WE                  ./path_to_the_west_texture sddddaaa

            C            225,30,0

 EA        ./path_to_the_east_texture













































































































































































































































































































































































































































































































































































































































































































































































































































































































































 F  220,100,0






































































        1111111111111111111111111
        1000000000110000000000001
        1011000001110000000000001
        1001000000000000000000001
111111110011000001110000000000001
100000001011000001110111111111111
11110111 11111011100000010001
11110111 1111101 101010010001
11000000110101011100000010001
10000000100000001100000010001
10000000100000001101010010001
11000001 10101011111011110N0111
11110111 1110101 101111010001
11111111 1111111 111111111111