 NO ./textures/wall_north.png asdfsssa
 SO ./textures/wall_south.png
 WE ./textures/wall_west.png

 EA ./textures/wall_east.png

 F       0,0,255

 C  255,0,0

11111111111111
1N000000000001
10000000000001
10000000000001
11111111111111