 NO ./textures/wall_north.png
 SO ./textures/wall_south.png
 WE ./textures/wall_west.png
 EA ./textures/wall_east.png

 F 111,0,110
 C 11,111,111

11111
10001
10N01
10001
11111